4cs=4CS
6502acme=ACMECrossAssembler_6502
6502kickass=KickAssembler_6502
6502tasm=TASM_6502_64TASS
abap=ABAP
actionscript=ActionScript
actionscript3=ActionScript3
ada=Ada
aimms=AIMMS
algol68=ALGOL68
apache=ApacheLog
applescript=AppleScript
apt_sources=APTSources
arm=ARM
asm=ASM_NASM
asp=ASP
asymptote=Asymptote
autoconf=autoconf
autohotkey=Autohotkey
autoit=AutoIt
avisynth=Avisynth
awk=Awk
bascomavr=BASCOMAVR
bash=Bash
basic4gl=Basic4GL
dos=Batch
bibtex=BibTeX
blitzbasic=BlitzBasic
b3d=Blitz3D
bmx=BlitzMax
bnf=BNF
boo=BOO
bf=BrainFuck
c=C
c_winapi=C_WinAPI
c_mac=CforMacs
cil=CIntermediateLanguage
csharp=CSHARP
cpp=CPLUSPLUS
cpp_winapi=CPLUSPLUS_WinAPI
cpp_qt=CPLUSPLUS_withQtextensions
c_loadrunner=C:Loadrunner
caddcl=CADDCL
cadlisp=CADLisp
cfdg=CFDG
chaiscript=ChaiScript
chapel=Chapel
clojure=Clojure
klonec=CloneC
klonecpp=CloneCPLUSPLUS
cmake=CMake
cobol=COBOL
coffeescript=CoffeeScript
cfm=ColdFusion
css=CSS
cuesheet=Cuesheet
d=D
dart=Dart
dcl=DCL
dcpu16=DCPU_16
dcs=DCS
delphi=Delphi
oxygene=DelphiPrism_Oxygene
diff=Diff
div=DIV
dot=DOT
e=E
ezt=Easytrieve
ecmascript=ECMAScript
eiffel=Eiffel
email=Email
epc=EPC
erlang=Erlang
fsharp=FSHARP
falcon=Falcon
fo=FOLanguage
f1=FormulaOne
fortran=Fortran
freebasic=FreeBasic
freeswitch=FreeSWITCH
gambas=GAMBAS
gml=GameMaker
gdb=GDB
genero=Genero
genie=Genie
gettext=GetText
go=Go
groovy=Groovy
gwbasic=GwBasic
haskell=Haskell
haxe=Haxe
hicest=HicEst
hq9plus=HQ9Plus
html4strict=HTML
html5=HTML5
icon=Icon
idl=IDL
ini=INIfile
inno=InnoScript
intercal=INTERCAL
io=IO
ispfpanel=ISPFPanelDefinition
j=J
java=Java
java5=Java5
javascript=JavaScript
jcl=JCL
jquery=jQuery
json=JSON
julia=Julia
kixtart=KiXtart
latex=Latex
ldif=LDIF
lb=LibertyBASIC
lsl2=LindenScripting
lisp=Lisp
llvm=LLVM
locobasic=LocoBasic
logtalk=Logtalk
lolcode=LOLCode
lotusformulas=LotusFormulas
lotusscript=LotusScript
lscript=LScript
lua=Lua
m68k=M68000Assembler
magiksf=MagikSF
make=Make
mapbasic=MapBasic
matlab=MatLab
mirc=mIRC
mmix=MIXAssembler
modula2=Modula2
modula3=Modula3
68000devpac=Motorola68000HiSoftDev
mpasm=MPASM
mxml=MXML
mysql=MySQL
nagios=Nagios
netrexx=NetRexx
newlisp=newLISP
nginx=Nginx
nimrod=Nimrod
text=None
nsis=NullSoftInstaller
oberon2=Oberon2
objeck=ObjeckProgrammingLangua
objc=ObjectiveC
ocaml_brief=OCalmBrief
ocaml=OCaml
octave=Octave
pf=OpenBSDPACKETFILTER
glsl=OpenGLShading
oobas=OpenofficeBASIC
oracle11=Oracle11
oracle8=Oracle8
oz=Oz
parasail=ParaSail
parigp=PARI/GP
pascal=Pascal
pawn=Pawn
pcre=PCRE
per=Per
perl=Perl
perl6=Perl6
php=PHP
php_brief=PHPBrief
pic16=Pic16
pike=Pike
pixelbender=PixelBender
plsql=PL_SQL
postgresql=PostgreSQL
postscript=PostScript
povray=POV_Ray
powershell=PowerShell
powerbuilder=PowerBuilder
proftpd=ProFTPd
progress=Progress
prolog=Prolog
properties=Properties
providex=ProvideX
puppet=Puppet
purebasic=PureBasic
pycon=PyCon
python=Python
pys60=PythonforS60
q=q_kdbPLUS
qbasic=QBasic
qml=QML
rsplus=R
racket=Racket
rails=Rails
rbs=RBScript
rebol=REBOL
reg=REG
rexx=Rexx
robots=Robots
rpmspec=RPMSpec
ruby=Ruby
gnuplot=RubyGnuplot
rust=Rust
sas=SAS
scala=Scala
scheme=Scheme
scilab=Scilab
scl=SCL
sdlbasic=SdlBasic
smalltalk=Smalltalk
smarty=Smarty
spark=SPARK
sparql=SPARQL
sqf=SQF
sql=SQL
standardml=StandardML
stonescript=StoneScript
sclang=SuperCollider
swift=Swift
systemverilog=SystemVerilog
tsql=T_SQL
tcl=TCL
teraterm=TeraTerm
thinbasic=thinBasic
typoscript=TypoScript
unicon=Unicon
uscript=UnrealScript
ups=UPC
urbi=Urbi
vala=Vala
vbnet=VB_NET
vbscript=VBScript
vedit=Vedit
verilog=VeriLog
vhdl=VHDL
vim=VIM
visualprolog=VisualProLog
vb=VisualBasic
visualfoxpro=VisualFoxPro
whitespace=WhiteSpace
whois=WHOIS
winbatch=Winbatch
xbasic=XBasic
xml=XML
xorg_conf=XorgConfig
xpp=XPP
yaml=YAML
z80=Z80Assembler
zxbasic=ZXBasic